Eleftheria_i_thanatos	subject.General
Geographical_distribution_of_Russian_speakers	subject.General
Order_of_Mapungubwe	subject.Agent
Genetics	subject.Science.Biology.General_Biology,
Form_of_government	subject.General
Colosseum	subject.Venue
Rock_(geology)	subject.General
Bronze_Age_(disambiguation)	subject.General
Member_states_of_the_League_of_Nations	subject.General
List_of_highest_mountains	subject.General
Earth_radius	subject.Agent
Annalee_Newitz	subject.People
U.S._Navy_Band	subject.General
Jack_(flag)	subject.General
Autonomous_(novel)	subject.General
Accademia_della_Crusca	subject.Organization
Executive_officer	subject.PersonFunction
Middle_East	subject.Geography.General_Geography,
List_of_countries_by_artichoke_production	subject.General
National_Assembly_of_Tajikistan	subject.Organization
Chryselephantine_sculpture	subject.Artwork
Pompeii	subject.History.Ancient_History_Classical_History_and_Mythology,
Captain_Michalis	subject.Book
Geneva_Lake	subject.Place
Democracy_(novel)	subject.General
Delano_Las_Vegas	subject.Hotel
Military_reserve_force	subject.MilitaryUnit
Vergina_sun	subject.General
Crete	subject.Place
Mediterranean_(disambiguation)	subject.General
Lists_of_mountains	subject.General
Franchthi_Cave	subject.Cave
Historical_linguistics	subject.Book
Nationalism_in_the_Middle_Ages	subject.General
Alexander_the_Great_(disambiguation)	subject.General
Purchasing_power_parity	subject.General
Gross_register_tonnage	subject.General
Xhosa_language	subject.Language
Apricot	subject.Everyday_life.Food_and_agriculture,
3-manifold	subject.General
Motto	subject.General
Outline_(list)	subject.General
Political_economy	subject.Citizenship.Politics_and_government,
President_(corporate_title)	subject.General
Flag_of_Russia	subject.Album
PhD	subject.University
Confederation_(disambiguation)	subject.General
Regional_Italian	subject.Language
Ozolian_Locris	subject.Settlement
Programming_language_theory	subject.Organisation
Greek_mythology	subject.Religion.Myths,
Saint_Petersburg_(disambiguation)	subject.General
Blazon	subject.Stadium
Sensor_network	subject.General
Macedonia_(disambiguation)	subject.General
Architecture	subject.Design_and_Technology.Architecture,
Computer_Science_(UIL)	subject.General
Pre-Greek_substrate	subject.General
Government_by_algorithm	subject.General
Climate	subject.Geography.General_Geography,
United_States_of_the_Ionian_Islands	subject.Place
De_facto	subject.Organisation
Alexander_the_Great	subject.People.Military_People,
Semi-presidential_republic	subject.General
Flag_of_Cuba	subject.General
Sanjak_of_Albania	subject.Place
Civil_flag	subject.Work
Coat_of_arms_of_Ukraine	subject.Fashion
United_Nations_Convention_Against_Torture	subject.General
Linguistic_reconstruction	subject.Company
Hellenic_Armed_Forces	subject.Organization
First-past-the-post_voting	subject.General
List_of_countries_by_apricot_production	subject.General
Food_and_Agriculture_Organization_Corporate_Statistical_Database	subject.General
Summit_(topography)	subject.General
Supreme_leader	subject.General
Geographical_distance	subject.Agent
Romang_language	subject.Language
Pantheon,_Rome	subject.General
Emirate_of_Bukhara	subject.Place
Paris	subject.Geography.European_Geography,
Troy_(disambiguation)	subject.General
Third_Hellenic_Republic	subject.Place
The_Nation,_Ontario	subject.General
Geode_(trade_association)	subject.General
1989_South_African_general_election	subject.Event
Archaic_Greece	subject.General
Regional_units_of_Greece	subject.MilitaryUnit
Archaeological_site	subject.Settlement
Hall_of_Mirrors	subject.Museum
Unique_identifier	subject.General
Stalagmite	subject.MilitaryUnit
Romania	subject.Geography.European_Geography.European_Countries,
Sortition	subject.Election
Byzantine_(disambiguation)	subject.General
Grecian_(disambiguation)	subject.General
Harvard_University	subject.CollegeOrUniversity
Coat_of_arms_of_the_Cook_Islands	subject.General
Nea_Nikomedeia	subject.Place
Achaea	subject.Place
Tajikistani_somoni	subject.Currency
Type_locality_(geology)	subject.General
Region_(disambiguation)	subject.General
Balkan_(disambiguation)	subject.General
Bosnian_language	subject.Language
Doric_order	subject.Animal
Administrative_division	subject.AnatomicalStructure
History_of_geodesy	subject.History
Flag_of_Ukraine	subject.Settlement
Clear_span	subject.General
Speech_scroll	subject.Device
Dionysus	subject.People
Fillia_Makedon	subject.General
Member_states_of_the_United_Nations	subject.Country
Petrograd_(disambiguation)	subject.General
Lhotse	subject.Place
Conceptual_schema	subject.Stadium
Overseas_country_of_France	subject.Place
Commonwealth_realm	subject.PopulatedPlace
Armenian_alphabet	subject.General
Geoinformatics	subject.Work
The_Web_(disambiguation)	subject.General
National_Anthem_(disambiguation)	subject.General
Democrat	subject.General
Switzerland_in_the_Napoleonic_era	subject.Place
Illyrians	subject.Band
Coat_of_arms_of_San_Marino	subject.General
Unity_is_Strength	subject.General
Biogenous_sediment	subject.General
Koine_(disambiguation)	subject.General
North_Aegean	subject.Place
Ancient_Crete	subject.General
Politics_of_country_subdivisions	subject.General
Federation_(disambiguation)	subject.General
Coat_of_arms_of_Geneva	subject.General
Plant	subject.Science.Biology.General_Biology,
Sponsored_top-level_domain	subject.Award
Data_model	subject.General
Pella_(Thessaly)	subject.General
Conway_polyhedron_notation	subject.General
Geode	subject.Building
Emperor_Frederick_II	subject.General
United_Kingdom	subject.Geography.Geography_of_Great_Britain,
Gov_(disambiguation)	subject.General
Country_(disambiguation)	subject.General
Mandatory_Palestine	subject.Place
Ukrainian_Soviet_Socialist_Republic	subject.Place
Gidi_Gov	subject.People
River_Thames	subject.Geography.Geography_of_Great_Britain,
Liberty_or_death	subject.General
Pella_(municipality)	subject.General
Armiger_(disambiguation)	subject.General
Greek	subject.General
Palace_of_Versailles	subject.Castle
Languages_of_the_Roman_Empire	subject.Language
United_Nations	subject.Citizenship.Politics_and_government,
1999_South_African_general_election	subject.Event
A_mari_usque_ad_mare	subject.General
Chryselephantine	subject.General
Delano_South_Beach	subject.Hotel
Flag_of_Peru	subject.General
Black_Sea	subject.Geography.General_Geography,
History_of_Russia	subject.History.General_history,
Election	subject.Citizenship.Politics_and_government,
Gaza_Strip	subject.Geography.Geography_of_the_Middle_East.Middle_Eastern_Countries,
Standard_German	subject.Language
List_of_kings_of_Macedonia	subject.General
Nation_Mountain	subject.Place
Algorithm	subject.Mathematics,
Wellington	subject.Geography.Geography_of_Oceania_Australasia,
Sovereign_Military_Order_of_Malta	subject.Place
Moria_(disambiguation)	subject.General
Spanish_language	subject.Language_and_literature.Languages,
Palestine	subject.General
List_of_countries_by_barley_production	subject.General
Arabic_language	subject.Language_and_literature.Languages,
Royal_Standard_of_the_United_Kingdom	subject.Album
Mycenaean_Greece	subject.General
Geneva	subject.Geography.European_Geography,
House_of_Menander	subject.ArchitecturalStructure
Albania	subject.Geography.European_Geography.European_Countries,
Rural_area	subject.Place
Romansh_language	subject.Language
Coat_of_arms_of_Vatican_City	subject.General
Cavaedium	subject.General
Lists_of_sovereign_states_and_dependent_territories	subject.General
Numerical_linear_algebra	subject.Book
Royal_Netherlands_Navy	subject.Organization
Alcetas_I_of_Macedon	subject.People
List_of_counties_in_Alabama	subject.General
List_of_forms_of_government	subject.General
State_of_Palestine	subject.Place
Dionysios_Solomos	subject.People
Geneva_Spur	subject.Place
Pasifika_Festival	subject.SocietalEvent
Flag_of_San_Marino	subject.General
Software_development	subject.Election
Count	subject.PersonFunction
Christian_nationalism	subject.General
Supreme_Assembly_(Tajikistan)	subject.General
Anticipatory_democracy	subject.Work
Whitney_Smith	subject.People
Palestinian_National_Authority	subject.Place
Justinian_the_Great	subject.General
Swiss_Confederation_(Napoleonic)	subject.General
Demographics_of_Kosovo	subject.General
Triband_(flag)	subject.General
Heraldry	subject.Everyday_life.Recreation,
Administrative_centre	subject.Settlement
Armenian_language	subject.Language
PIE_(disambiguation)	subject.General
Belgium_(disambiguation)	subject.General
Outline_of_political_science	subject.General
Electoral_system	subject.General
Scotland_(disambiguation)	subject.General
Earl	subject.People
Decentralized_Administration_of_the_Aegean	subject.Organization
Plurality_block_voting	subject.General
City	subject.Geography.General_Geography,
Palestine_(region)	subject.General
Justinian_I	subject.People
Time_series	subject.General
Arabic_(disambiguation)	subject.General
Location	subject.General
Geocode	subject.General
Elections_by_country	subject.General
Rhombicosidodecahedron	subject.General
Monaco-Ville	subject.General
Lower_house	subject.Legislature
Regions_of_Greece	subject.General
Temple	subject.Building
Pella_(disambiguation)	subject.General
Nigeria	subject.Countries,
Independent_Albania	subject.Place
Executive_(government)	subject.General
Asia_Minor	subject.Country
Chemical_formula	subject.General
Ancient_Greek	subject.Language
Aegae_(Macedonia)	subject.General
Proto-Indo-European_language	subject.Museum
Prehistoric_Greece	subject.General
History_of_Vatican_City	subject.History
Tsardom_of_Russia	subject.Place
Particular_Church	subject.General
Argolis	subject.Place
Unity_makes_strength	subject.TVShow.IBT
Politics	subject.Citizenship.Politics_and_government,
Language_(disambiguation)	subject.General
National_emblem	subject.General
Flag_of_Bulgaria	subject.General
Livadochori,_Lemnos	subject.General
Classical_Antiquity	subject.General
Opium_poppy	subject.General
Gilbert_du_Motier,_Marquis_de_Lafayette	subject.General
Palaestina_Secunda	subject.Place
Flag_of_Greece	subject.General
National_emblem_of_North_Macedonia	subject.General
Ukrainian_language	subject.Language
.gov	subject.Identifier
Denomination_(currency)	subject.General
France	subject.Geography.European_Geography.European_Countries,
Athens_(disambiguation)	subject.General
Latin	subject.Language_and_literature.Languages,
Dutch_language	subject.Language_and_literature.Languages,
County	subject.General
Peace_of_Westphalia	subject.TelevisionShow
Platonic_solid	subject.General
Legislature	subject.Organisation
Greek_flag	subject.General
Leaflet_(software)	subject.General
Referendums	subject.General
Garland	subject.General
Christianity_in_Vatican_City	subject.General
Byzantine_architecture	subject.Company
Helois	subject.General
Coat_of_Arms_of_Greece	subject.General
Requirement	subject.Mollusca
Napoleonic_Wars	subject.History.Pre_1900_Military,
Hellenic_Air_Force	subject.Organization
Paraguay,_Cuba	subject.General
Negev_Desert	subject.General
Golden_Larnax	subject.General
Bosnia_(region)	subject.General
Musala	subject.Place
Eponym	subject.People
Embassy_of_Germany,_Saint_Petersburg	subject.General
Argolis_(constituency)	subject.General
Language_family	subject.Band
Athene_(Cynuria)	subject.General
Archaeological_culture	subject.Insect
Wisconsin	subject.Place
Nazarene_movement	subject.General
Geodetic_coordinates	subject.General
Federation_of_Arab_Republics	subject.Place
GEOID	subject.General
Imperial_Guard_(Napoleon_I)	subject.General
National_flag	subject.Album
Eastern_Orthodox_Church	subject.Religion.Religious_movements_traditions_and_organizations,
Russian_Imperial_Standard	subject.General
Administrative_regions_of_Greece	subject.MusicalArtist
Languages_of_Greece	subject.General
Temple_of_Athena_(disambiguation)	subject.General
Albanian_Principalities	subject.General
Tinsel	subject.ChemicalCompound
Rechtsstaat	subject.MilitaryUnit
State_ensign	subject.General
Kiritimati	subject.Place
Official_residence	subject.Building
Languages_of_Kosovo	subject.General
Country_(identity)	subject.General
Monaco	subject.Geography.European_Geography.European_Countries,
Balkans	subject.Place
Tajikistan	subject.Countries,
Flat_Earth	subject.Religion.Religious_disputes,
Tabacco_(disambiguation)	subject.General
United_States	subject.Geography.North_American_Geography,
Countryside_(disambiguation)	subject.General
North_Africa	subject.Geography.African_Geography,
Ankara	subject.Place
Geoid	subject.Album
Monarch	subject.People
Geographic_regions_of_Greece	subject.MusicalArtist
Politics_of_present-day_states	subject.General
Peabody,_Massachusetts	subject.General
North_Macedonia	subject.Place
President_(government_title)	subject.General
Flag_of_North_Macedonia	subject.General
Hellenic_Republic_(disambiguation)	subject.General
Versailles_(disambiguation)	subject.General
Unitary_state	subject.PopulatedPlace
Aegean_Islands	subject.Place
Nation_River_(British_Columbia)	subject.General
Archaeology	subject.History.Archaeology,
Albania_(disambiguation)	subject.General
Denes_nad_Makedonija	subject.MusicalWork
Model_of_computation	subject.VideoGame
List_of_administrative_divisions_by_country	subject.General
Pallas_Athena_(disambiguation)	subject.General
Web_application	subject.Software
Alepotrypa_Cave	subject.General
Literal_translation	subject.Work
Romanian_language	subject.Language
Ancient_Greece	subject.History.Ancient_History_Classical_History_and_Mythology,
Ecuador	subject.Countries,
Regime_of_the_Colonels	subject.General
List_of_U.S._state_songs	subject.General
List_of_vexillologists	subject.General
Flag_of_Vatican_City	subject.General
Albanian_principalities	subject.General
Uniform_star_polyhedron	subject.General
Harold_Scott_MacDonald_Coxeter	subject.People
L1_speakers	subject.General
Ecclesia_(ancient_Athens)	subject.General
Nelson_Mandela	subject.People.Political_People,
Dushanbe	subject.Place
Majoritarian_representation	subject.Software
Parthenon	subject.Design_and_Technology.Architecture,
Persian_Wars_(disambiguation)	subject.General
Archimedean_solid	subject.General
Two-round_system	subject.General
Address_geocoding	subject.General
Macedon_railway_station,_Victoria	subject.General
Eurasia	subject.Place
Aegean_civilization	subject.General
Empress_dowager	subject.Book
Indonesia	subject.Countries,
Vergina_Sun	subject.Place
Greek_language	subject.Language
Cappadocian_Greek	subject.Language
Mandela_(disambiguation)	subject.General
Modern_flat_Earth_beliefs	subject.General
Australia	subject.Geography.Geography_of_Oceania_Australasia,
List_of_current_heads_of_state_and_government	subject.General
Yoruba_people	subject.Band
Indo-European_(disambiguation)	subject.General
Greece	subject.Geography.European_Geography.European_Countries,
Polity	subject.PopulatedPlace
Lake_Geneva	subject.Place
Denarius	subject.Agent
Plurality_voting	subject.General
Danube	subject.Geography.European_Geography,
Chrysler_Building	subject.ArchitecturalStructure
Macedonia_(ancient_kingdom)	subject.General
Flag_of_the_Cook_Islands	subject.General
Geotagging	subject.General
Switzerland_Township,_Monroe_County,_Ohio	subject.General
National_Archaeological_Museum,_Athens	subject.General
League_of_Nations_mandate	subject.Agent
Russkaya_Pravda	subject.Film
Sybaris	subject.City
Territory	subject.General
Minoan_civilization	subject.History.Ancient_History_Classical_History_and_Mythology,
Democrat_(disambiguation)	subject.General
First_Hellenic_Republic	subject.Place
Neolithic	subject.Country
Intergovernmental_organization	subject.Organisation
Parliamentary_confidence	subject.General
Code	subject.Settlement
2011_Australian_census	subject.General
List_of_largest_producing_countries_of_agricultural_commodities	subject.General
Communes_of_France	subject.General
Table_of_World_Heritage_Sites_by_country	subject.EthnicGroup
West_Asia	subject.AdministrativeRegion
MENA	subject.Company
Stoa_of_Attalos	subject.ArchitecturalStructure
William_Crampton	subject.People
Geophysics	subject.AdministrativeRegion
Macedon_(disambiguation)	subject.General
Turkey	subject.Geography.European_Geography.European_Countries,
Coat_of_arms_of_Russia	subject.General
Constitution_of_the_Athenians_(Aristotle)	subject.General
Type_site	subject.Place
2016_Australian_census	subject.General
Serbia	subject.Geography.European_Geography.European_Countries,
Vexillology	subject.General
Presidential_Mansion,_Athens	subject.General
Geneva_(disambiguation)	subject.General
Requirements_analysis	subject.General
Koine_Greek	subject.Language
National_colours	subject.General
Democracy	subject.Citizenship.Politics_and_government,
Italiano_(disambiguation)	subject.General
Parthenon_(disambiguation)	subject.General
Flag_of_Turkey	subject.Album
Ayni_Opera_and_Ballet_Theatre	subject.ArchitecturalStructure
Countries_of_the_United_Kingdom	subject.Country
Ensign,_Alberta	subject.General
Quartz	subject.Geography.Mineralogy,
Magna_Graecia	subject.Place
Flag_of_the_Palestinian_National_Authority	subject.General
Truncated_icosidodecahedron	subject.General
French_Imperial_Eagle	subject.General
Albanian_language	subject.Language
President_of_Greece	subject.People
Canada_Dock	subject.Ship
Geography_of_Greece	subject.MusicalArtist
Good_governance	subject.General
Geode_(disambiguation)	subject.General
Vincenzo_Italiano	subject.People
Grecian	subject.General
Century_of_Progress	subject.River
Indo-European	subject.General
The_World_(archipelago)	subject.General
Ladin	subject.Language
Aegean_Sea_(theme)	subject.General
Monarchism	subject.Organisation
Seifert_fiber_space	subject.General
Prince_Charles_(disambiguation)	subject.General
Treaty_of_Versailles	subject.History.British_History.British_History_Post_1900,
Self-governance	subject.General
Troy_VIII	subject.General
Flag_of_Canada	subject.Album
Second_Hellenic_Republic	subject.Place
IMO_number	subject.Village
Republic_of_Turkey	subject.Country
Swiss_Confederation	subject.Company
Democracy_indices	subject.General
Shirinsho_Shotemur	subject.People
Wythoff_symbol	subject.General
Alepotrypa_cave	subject.General
Flag_of_France	subject.Colour
Geographic_coordinate_system	subject.General
Geodynamics	subject.Disease
Lists_by_country	subject.TelevisionShow
Athens	subject.Geography.European_Geography,
Cephalonia	subject.Place
Streamliner	subject.MeanOfTransportation
Franz_Hanfstaengl	subject.People
Indo-European_languages	subject.Language
Athena_Parthenos	subject.Artwork
Astronomy	subject.Science.Physics.Space_Astronomy,
Knot	subject.Software
Amyntas_I_of_Macedon	subject.People
Ratification	subject.RadioStation
Transom_(nautical)	subject.General
Byzantine_Greeks	subject.EthnicGroup
Diocese	subject.Settlement
Languages_of_Albania	subject.General
Nuptse	subject.Place
History_of_Greece	subject.History.Ancient_History_Classical_History_and_Mythology,
Roman_Empire	subject.History.British_History.British_History_1500_and_before_including_Roman_Britain,
Government_(disambiguation)	subject.General
Constitutional_monarchy	subject.Citizenship.Politics_and_government,
Greeks	subject.Band
Unincorporated_area	subject.City
United_Nations_(disambiguation)	subject.General
Pericles	subject.People.Military_People,
Politics_of_Greece	subject.Company
Balto-Slavic_languages	subject.General
Macedon,_Victoria	subject.General
Philip_II_of_Macedon	subject.People
Canton_of_Geneva	subject.Place
Autotomy	subject.General
Constitutional_history_of_Greece	subject.History
Tree_model	subject.General
Germany_(disambiguation)	subject.General
Federal_Amateur_Hockey_League	subject.Organization
Coat_of_arms_of_Bulgaria	subject.HorseTrainer
List_of_kings_of_Macedon	subject.General
Languages_of_Montenegro	subject.General
State_church	subject.General
Direct_election	subject.General
Tricolour_(flag)	subject.General
Vergina	subject.Place
U.N._(group)	subject.General
Computer_science	subject.IT.Computer_Programming,
Europe_(disambiguation)	subject.General
Monarchy_of_the_United_Kingdom	subject.Country
State_flag	subject.General
Mercurial	subject.Software
Mountain_range	subject.Place
Democratic_Party_(Cyprus)	subject.General
Belgium_(town),_Wisconsin	subject.General
Ensign_(flag)	subject.General
Cook_Islands	subject.Geography.Geography_of_Oceania_Australasia,
Canada	subject.Geography.North_American_Geography,
Municipalities_of_Switzerland	subject.Organisation
Greene_County,_Alabama	subject.General
Bronze_Age	subject.History.Ancient_History_Classical_History_and_Mythology,
Macedon	subject.Geography.European_Geography,
Uniform_polyhedron	subject.General
Pedestal	subject.Organisation
Continuous_function	subject.General
Palestinian_enclaves	subject.General
Italiana_(album)	subject.General
Genetic_relationship_(linguistics)	subject.General
Purchasing_power	subject.General
Greek_junta	subject.Place
Central_Macedonia	subject.Place
Switzerland_(disambiguation)	subject.General
Regional_language	subject.Language
VLSI	subject.General
Supraglacial_lake	subject.General
Kosovo	subject.Geography.European_Geography.European_Countries,
Togo	subject.Countries,
League_of_Nations	subject.Citizenship.Politics_and_government,
Greco_Deco	subject.General
St._Petersburg,_Florida	subject.General
Military_base	subject.ArchitecturalStructure
Aegean_Sea	subject.Place
Doric_Greek	subject.Language
Head_of_state	subject.PersonFunction
South_Australia	subject.PopulatedPlace
Arabic	subject.Language
Nationalist_(disambiguation)	subject.General
Tablinum	subject.Building
Figure_of_the_Earth	subject.General
Index_of_politics_articles	subject.General
Citadel	subject.Organization
Flags_and_arms_of_cantons_of_Switzerland	subject.General
Coxeter_diagram	subject.General
Excellency	subject.General
List_of_countries_by_apple_production	subject.General
Style_(form_of_address)	subject.General
Software_release_life_cycle	subject.Software
Strategos	subject.General
Coxeter	subject.General
Nation_state	subject.Place
Grenadier	subject.General
County_(Taiwan)	subject.General
Classical_Greece	subject.Country
Euler_characteristic	subject.General
Paraguay	subject.Countries,
Population_of_the_Byzantine_Empire	subject.General
Constitution_of_Greece	subject.General
Written_language	subject.General
Sea	subject.Geography.General_Geography,
1994_South_African_general_election	subject.Event
Armiger	subject.People
Data_modeling	subject.Election
Athene_(disambiguation)	subject.General
National_Assembly_of_South_Africa	subject.Organization
Cook_Island	subject.General
Ancient_Greek_dialects	subject.General
Language	subject.Language_and_literature.Languages,
Material_culture	subject.Organisation
Governance	subject.General
Lake_Geneva_(Minnesota)	subject.General
List_of_states_with_limited_recognition	subject.General
Lambda	subject.RadioStation
Micronation	subject.Organisation
Mount_Everest	subject.Geography.Geography_of_Asia,
Achaemenid_Macedonia	subject.Place
Russia	subject.Geography.European_Geography.European_Countries,
Acropolis	subject.Settlement
Canada_House,_Sheffield	subject.General
French_language	subject.Language_and_literature.Languages,
Bulgaria	subject.Geography.European_Geography.European_Countries,
Roundness_(geology)	subject.General
Presidential_system	subject.General
Greece_(disambiguation)	subject.General
Switzerland,_Florida	subject.General
Nation	subject.Country
Asos	subject.Place
Ship	subject.Design_and_Technology.Engineering,
Statue	subject.Artwork
Le_Louvre_des_Antiquaires	subject.ArchitecturalStructure
Scotch_marine_boiler	subject.General
Regions_of_ancient_Greece	subject.Settlement
Hikitia	subject.Product
Neolithic_Greece	subject.General
Country	subject.Geography.General_Geography,
Flag_of_Macedonia	subject.General
Tonne	subject.Organisation
Scotland	subject.Geography.Geography_of_Great_Britain,
Geode_Capital_Management	subject.Company
Dependent_territory	subject.PopulatedPlace
Cantons_of_France	subject.Settlement
Frederick_Kindleberger_Stone_House_and_Barn	subject.Place
Coats_of_arms_of_the_Holy_See	subject.General
Theme_(country_subdivision)	subject.General
Paraguay_(disambiguation)	subject.General
Proto-Greek_language	subject.General
Germanium	subject.Science.Chemistry.Chemical_elements,
Canada_House_(Berlin)	subject.General
Arcadian_League	subject.Place
Programmer	subject.People
Stripped_Classicism	subject.General
Southern_Africa	subject.Geography.African_Geography,
Pella,_Jordan	subject.General
Topographic_prominence	subject.General
Bulgar_language	subject.Language
World_Leaders	subject.Company
Silicate_mineral	subject.General
European_Union	subject.Citizenship.Politics_and_government,
Vatican_Museums	subject.ArchitecturalStructure
Lake_Geneva_(disambiguation)	subject.General
Macedon_railway_station	subject.Infrastructure
By-election	subject.Election
Computer_programming	subject.IT.Computer_Programming,
Smokebox	subject.Place
Belgium	subject.Geography.European_Geography.European_Countries,
Monaco_(disambiguation)	subject.General
Pella	subject.General
Latin_(disambiguation)	subject.General
Ecclesia_(ancient_Greece)	subject.General
Mediterranean_sea_(oceanography)	subject.General
Autonomy	subject.General
Sedimentary_rock	subject.MeanOfTransportation
Cook_Islands_(disambiguation)	subject.General
Geneva,_Alabama	subject.General
Bad_governance	subject.General
Greco-Persian_Wars	subject.Event
Confederation	subject.Organisation
Himni_i_Flamurit	subject.MusicalWork
Swiss_Confederation_(disambiguation)	subject.General
Democracy_(disambiguation)	subject.General
Glacial_lake	subject.Lake
Orlando_Ferguson	subject.General
Classical_antiquity	subject.MusicGenre
Anthem_of_the_21st_of_April	subject.General
Achaean_Doric_Greek	subject.General
International_Federation_of_Vexillological_Associations	subject.Organization
History_of_the_Hellenic_Republic	subject.History
Art_Deco	subject.MusicGenre
Lum_Choar	subject.Place
Arcadian_Greek	subject.General
Classical_architecture	subject.General
Washington_Navy_Yard	subject.Company
Districts_of_Switzerland	subject.General
Rome	subject.Geography.European_Geography,
Troy	subject.City
Federation	subject.Organisation
Romanesco_dialect	subject.Language
Cook_Islands_Federation	subject.Place
Ancient_Greek_language	subject.Language
Direct_democracy	subject.General
Elongated_square_gyrobicupola	subject.General
Spherical_Earth	subject.General
Politics_by_country	subject.General
Athena	subject.Religion.Divinities,
UN_(disambiguation)	subject.General
President_of_Cuba	subject.People
Vexillological_symbol	subject.General
Peter_von_Cornelius	subject.People
Ukraine	subject.Geography.European_Geography.European_Countries,
Russia_(disambiguation)	subject.General
Capital_city	subject.City
Federated_state	subject.Politician
Ministry_(collective_executive)	subject.General
El_Djem	subject.Place
Modern_Greek	subject.Language
Tobacco	subject.Science.Biology.Plants,
Anatolia	subject.Place
South_Col	subject.Place
List_of_territorial_disputes	subject.General
San_Marino	subject.Geography.European_Geography.European_Countries,
Athene_(bird)	subject.General
Nation_Peak	subject.Place
Morality	subject.MusicGenre
Majority_rule	subject.Country
Ecuador_(disambiguation)	subject.General
Attica	subject.Place
Albanian_culture	subject.General
Argead_dynasty	subject.Building
Flat_Earth_(disambiguation)	subject.General
Computer_science_(disambiguation)	subject.General
Palace_of_the_Nation_(Dushanbe)	subject.General
Artichoke	subject.Grape
Robes_of_the_British_peerage	subject.General
Allies_of_World_War_II	subject.Place
Italy	subject.Geography.European_Geography.European_Countries,
Stern	subject.General
Ancient_Greek_religion	subject.General
Nationalist_Party_(Iceland)	subject.General
The_Citadel	subject.CollegeOrUniversity
Doric_dialect_(Scotland)	subject.General
Philipp_Foltz	subject.People
Charles_III	subject.People
Barbes	subject.General
Southern_Europe	subject.Country
Religion_in_ancient_Greece	subject.General
De_jure	subject.Organisation
Indirect_election	subject.Election
Cook_Island_(disambiguation)	subject.General
Human_rights_in_Greece	subject.General
List_of_international_rankings	subject.General
Germany	subject.Geography.European_Geography.European_Countries,
List_of_Russian_flags	subject.General
Victoria_(Australia)	subject.General
Art_Deco_(disambiguation)	subject.General
Ukraine_(disambiguation)	subject.General
County_(disambiguation)	subject.General
Vegetation	subject.Science.Biology.Plants,
World_Wide_Web	subject.IT.Websites_and_the_Internet,
Poliochne	subject.Settlement
Government	subject.Citizenship.Politics_and_government,
Flag	subject.MusicalWork
Sovereign_(British_coin)	subject.General
Autonomous_administrative_division	subject.Organisation
Coat_of_arms_of_Monaco	subject.General
Florence_Cathedral	subject.LandmarksOrHistoricalBuildings
Countryside	subject.General
Liberal_democracy	subject.Citizenship.Politics_and_government,
Russian_language	subject.Language_and_literature.Languages,
Geomatics	subject.Sport
Helladic_chronology	subject.General
Cyprus	subject.Geography.European_Geography.European_Countries,
Map	subject.Work
National_church	subject.General
Bulgarian_language	subject.Language
Proto-Indo-European	subject.General
Arlington,_Massachusetts	subject.General
Demarchy	subject.General
Greek_(disambiguation)	subject.General
Art_Deco_in_the_United_States	subject.General
The_World_is_Round_(disambiguation)	subject.General
Saint_Petersburg	subject.Geography.European_Geography,
Coat_of_arms_of_Palestine	subject.General
Geodesy	subject.Sport
Macedonia_(region)	subject.General
National_Anthem_(2003_film)	subject.General
Pnyx	subject.Mountain
List_of_sovereign_states	subject.Geography.General_Geography,
Graph_algorithm	subject.General
Ensign_(disambiguation)	subject.General
Personification	subject.General
Food_and_Agriculture_Organization	subject.Organization
History_of_democracy	subject.Citizenship.Politics_and_government,
Greater_Middle_East	subject.Place
Paris_(disambiguation)	subject.General
Cantons_of_Switzerland	subject.PopulatedPlace
Paleolithic	subject.Country
Obverse_and_reverse	subject.General
Athena_(disambiguation)	subject.General
National_parish	subject.Settlement
Beam_(structure)	subject.General
Maritime_flag	subject.Album
Defacement_(flag)	subject.General
Flag_of_Italy	subject.General
London	subject.Geography.Geography_of_Great_Britain,
German_language	subject.Language_and_literature.Languages,
Second_Temple_of_Hera_(Paestum)	subject.General
Districts_of_Afghanistan	subject.Settlement
Equator	subject.RoadJunction
Ton	subject.Organisation
Ancient_Macedonians	subject.EthnicGroup
Paramount_Leader	subject.General
Bay_laurel	subject.General
Athenian_democracy	subject.People
Southeastern_Anatolia_Region	subject.Place
Trapeza,_Crete	subject.General
Dina_Boluarte	subject.People
Attic_Greek	subject.Language
Naskh_(script)	subject.General
Anatolia_(disambiguation)	subject.General
Athenian_(disambiguation)	subject.General
Industrial_unionism	subject.Organisation
System_of_measurement	subject.Book
Ancient_Macedonian_language	subject.Language
Algebraic_topology	subject.Organisation
Diplomatic_mission	subject.Band
Coat_of_arms_of_Albania	subject.Film
Arcadocypriot_Greek	subject.Language
Territory_(disambiguation)	subject.General
List_of_ancient_Greek_tribes	subject.General
Artifact_(archaeology)	subject.General
Parliamentary_republic	subject.People
Hymn_to_Liberty	subject.Poem
Palace_of_Nations	subject.ArchitecturalStructure
Achievement_(heraldry)	subject.General
United_States_Navy_Band	subject.Organization
Official_language	subject.Language
Nation_(disambiguation)	subject.General
Arc_measurement	subject.General
Flag_of_Paraguay	subject.General
Eastern_Christianity	subject.General
Mediterranean_Sea	subject.Geography.General_Geography,
Macedonia	subject.General
Region	subject.Settlement
Ancient_Agora_Museum	subject.General
Coat_of_arms_of_Greece	subject.General
Languages_of_Italy	subject.Language
Unicameralism	subject.Company
Katerina_Sakellaropoulou	subject.People
His_Excellency	subject.General
U.S._state	subject.Geography.North_American_Geography,
Mainland_Greece	subject.General
European_Convention_on_Human_Rights	subject.Agent
National_ensign	subject.General
Proto-Indo-Europeans	subject.Organisation
George_W._Hart	subject.People
Vatican_City	subject.Geography.European_Geography.European_Countries,
Liberty_or_Death_(disambiguation)	subject.General
Helios	subject.Agent
Bulgaria_(disambiguation)	subject.General
Europe	subject.Geography.European_Geography,
Latin_language	subject.Language
Ensign	subject.Album
Knossos	subject.Place
Flag_of_Estonia	subject.General
Regions_of_Greece_(disambiguation)	subject.General
Hellenic_languages	subject.Organisation
Nationalism	subject.Citizenship.Politics_and_government,
Cappadocian_Greeks	subject.EthnicGroup
Pie	subject.Food
Byzantine_Empire	subject.History.General_history,
Macedonia_(Greece)	subject.General
Tajik_language	subject.Language
Mycenaean_Greek	subject.Language
History_of_modern_Greece	subject.History
Typology_(archaeology)	subject.General
Attic_Greek_language	subject.General
Proto-language	subject.General
Pie_(disambiguation)	subject.General
Crete_(disambiguation)	subject.General
Human_rights_in_Afghanistan	subject.Scientist
NASA	subject.Company
Yoruba_language	subject.Language
Munich	subject.Geography.European_Geography,
Triangle	subject.General
Epirus	subject.Place
Acropolis_of_Athens	subject.Place
Walworth_County,_Wisconsin	subject.General
Makedon_(mythology)	subject.General
President_of_the_Council_of_State	subject.General
Turkish_language	subject.Language
Germanic_languages	subject.Language
Nations_League_(disambiguation)	subject.General
Employment	subject.Business_Studies.Business,
Greek_Revolution	subject.General
Calque	subject.Food
Indo_people	subject.EthnicGroup
Mytilene	subject.Place
Barbes_(disambiguation)	subject.General
United_Nations_(band)	subject.General
National_Archaeological_Museum_of_Athens	subject.Museum
Convention_Relating_to_the_Status_of_Refugees	subject.General
Spatial_reference_system	subject.General
Greeks_(disambiguation)	subject.General
Gross_tonnage	subject.Work
Paisley,_Renfrewshire	subject.General
Cook_Island_(New_South_Wales)	subject.General
Holy_See	subject.Place
Ethnic_groups	subject.General
National_anthem	subject.MusicGenre
Geometry	subject.Mathematics,
Macedonian_language	subject.Language
Very_High_Speed_Integrated_Circuit	subject.General
Ligurian_(Romance_language)	subject.General
Head_of_state_(disambiguation)	subject.General
Vascular_plant	subject.General
Shughnon_District	subject.Place
Turkey_(bird)	subject.General
Switzerland	subject.Geography.European_Geography.European_Countries,
Cyprus_(disambiguation)	subject.General
Thebes,_Greece	subject.General
Greek_Dark_Ages	subject.Country
Iran	subject.Geography.Geography_of_the_Middle_East.Middle_Eastern_Countries,
Medieval_Greek	subject.People
Victoria_(state)	subject.General
Pericles_with_the_Corinthian_helmet	subject.Artwork
Houston	subject.Place
Pelasgians	subject.General
Plinth	subject.Airport
Flag_of_Macedonia_(Greece)	subject.General
State_religion	subject.Organisation
Repository_(version_control)	subject.General
Christianity_in_Europe	subject.EthnicGroup
Sovereign_state	subject.Organisation
Irreligion	subject.Disease
Ensign_(rank)	subject.General
Analysis	subject.Election
General_ticket	subject.Software
Cretan_Greek	subject.Language
Policy	subject.General
Italian_language	subject.Language
Balkan,_Kentucky	subject.General
Canada_(disambiguation)	subject.General
Democracy_(newspaper)	subject.General
Order_of_Canada	subject.History.Military_History_and_War,
Computer_Science	subject.University
